##############################
#######...........s..s...#####
#######.###########..###.#####
#######s####o........###s#####
###...s..................#####
##...##..................#####
##...##..###########.###s#####
##...##s############.###.#####
###s###.############.###.#####
###.###.############.###.#####
###.###.############.###.#####
###.###.############.###.#####
###.###.############.###.#####
###.###s############.###.#####
###.##...s...........###.#####
###.##...###########.###s#####
###.###s############s###..####
###...............s...s...####
#######.###########...##..####
#######.###########...########
#######s######################
######...#####################
######...#####################
##############################
##############################